Afghan - afghani
African - african
American - newamerican
Arabian - arabian
Argentine - argentine
Armenian - armenian
Asian - asianfusion
Australian - australian
Asturian - asturian
Austrian - austrian
Bangladeshi - bangladeshi
Barbeque - bbq
Belgian - belgian
Brazilian - brazilian
British - british
Burmese - burmese
Canadian - newcanadian
Cambodian - cambodian
Caribbean - caribbean
Chinese - chinese
Danish - danish
Cuban - cuban
French - french
German - german
Greek - greek
Halal - halal
Hawaiian - hawaiian
Hungarian - hungarian
Indian - indpak
Indonesian - indonesian
Irish - irish
Israeli - israeli
Italian - italian
Japanese - japanese
Korean - korean
Kebab - kebab
Malaysian - malaysian
Mediterranean - mediterranean
Mexican - mexican
Pakistani - pakistani
Persian - persian
Pizza - pizza
Portuguese - portuguese
Rice - riceshop
Romanian - romanian
Russian - russian
Salad - salad
Sandwiches - sandwiches
Singaporean - singaporean
Spanish - spanish
Seafood - seafood
Swiss - swissfood
Swedish - swedish
Turkish - turkish
Thai - thai
Vegetarian - vegetarian
Vegan - vegan
Waffles - waffles